N . . P . . . . .
. . P S P . . . .
P P P P . . . . .
P A P . . . . . .
P P P . . . . . .
. . . . . . . . .
. . . . . . . . .
. . . . K . P P P
. . . . . . P A P
[-1, -1] 16.1093 12.1832

