N....K...
.........
.........
.........
.........
PPP...P..
PAP..PSP.
PPP...P..
.........
