N........
..P......
.PSPPPP..
..P.PAP..
....PPP..
.K.......
.........
.........
.........
