N........
.........
...K.....
.........
......P..
.....PSP.
......P..
.........
.........
