N.PPPPPP.
..PAKPAP.
..PPPPPP.
.........
PP.......
AP.......
PP.....P.
......PSP
.......P.