N.PPPPPP.
..PAPPAP.
..PPPPPP.
.........
PP.......
AP.......
KP.....P.
......PSP
.......P.
