K......PA
...P...PP
..PSP....
...P.....
.........
.........
.........
.........
.........
